10 10
.........T
XX...XX...
X..G......
XXXXXXX...
G...XG....
XX..X.X...
....XXX...
XX...XX.K.
S.........
XX...XX..G
